5,5
0,0,0,0,0,0,0,0,0,0
0,0,0,4,4,4,0,0,0,0
0,0,0,4,1,4,0,0,0,0
0,0,0,4,0,4,4,4,4,0
0,4,4,4,2,0,2,1,4,0
0,4,1,0,2,0,4,4,4,0
0,4,4,4,4,2,4,0,0,0
0,0,0,0,4,1,4,0,0,0
0,0,0,0,4,4,4,0,0,0
0,0,0,0,0,0,0,0,0,0