2,4
0,0,0,0,0,0,0,0,0,0
0,4,4,4,4,4,4,4,0,0
0,4,0,0,0,0,0,4,4,4
4,4,2,4,4,4,0,0,0,4
4,0,0,0,2,0,0,2,0,4
4,0,1,1,4,0,2,0,4,4
4,4,1,1,4,0,0,0,4,0
0,4,4,4,4,4,4,4,4,0
0,0,0,0,0,0,0,0,0,0
0,0,0,0,0,0,0,0,0,0